1111111111111111111111111111111111
1E00000000000000000000000000000001
1110010100100000101001000000010101
1110010010101010001001000000010101
1P10000010100000000000000000000001
1000000000000000000000000000000001
1000000000000000000000000000000001
100000000000G000000000000000000001
1000000000000000000000000000000001
1000000000000000000G00000000000001
1000000000000000000000000000000001
100000000000000000000000G0000000C1
1111111111111111111111111111111111