111111111111
1E00P0000011
111001010001
111001000011
1P0000000011
111001001011
111001001011
1C1001001011
111111111111