111111111111
1E0000000011
111001010011
111001000011
1P0000000011
111001001011
111001001011
1C1001001011
111111111111